test
5 5
1,1,0,1,1
1,1,1,1,1
0,1,H,1,0
1,1,1,1,1
1,1,0,1,1
